111111111111
10P1CCC01001
100010001
1E0000001
111111111