111111111
10P0C0C01
100000001
1E0000001
111111111